//EnglishVowels
AA	AA
AE	AE
AH	AH
AH2	AH
AO	AO
OU	AO
AW	AW
AY	AY
EH	EH
EY	EY
IH	IH
IY	IY
OW	OW
OY	OY
UH	UH
UW	UW
ER	ER
EL  EL
EM	EM
EN	EN
OR	OW.R

//EnglishConsonants
B	B
CH	CH
D	D
DH	DH
F	F
G	G
HH	HH
JH	JH
K	K
L	L
M	M
N	N
NG	NG
NGG NGG
P	P
R	R
S	S
SH	SH
T	T
TH	TH
V	V
W	W
WH	WH
Y	Y
Z	Z
ZH	ZH

//EnglishExtra
&   AE
EA	AE
UY  AY
X	k

//French
O	O
A~  ?
O~  ?
E~	?
WY	?
ë	?
ü   ?
ö	?
ë~	?
RH	?

GH	?
HHH	?
FH	?
BB	?
RR	?
TS  TS
DZ  DZ
H+	?
SH+	?
R'	DX
D'	DX
:	?
-	Q