//EnglishVowels
AA	a
AE	ȧ
AH	u̇
AH2	e
AO	au̇
OU	ou̇
AW	ȧu
EH	ė
IH	ı
IY	i
IY2 ee
OW	ȯ
AY	ai
EY	ėi
OY	oi
UY  u̇i
UH	uu
UW	u
UW2	u
ER	er
EL  el
EM	em
EN	en
OR  or
&   á
EA	ae

//EnglishConsonants
B	b
CH	ch
D	d
DH	dh
F	f
G	g
HH	h
JH	j
K	k
L	l
M	m
N	n
NG	ng
NGG ng
NY	ny
P	p
R	r
S	s
SH	sh
T	t
TH	th
V	v
W	w
WH	hw
Y	y
Z	z
ZH	ж
X	k̇

//French
O	o
A~  à
O~  ò
E~	è
WY	wy
ë	ë
ü   ü
ö	ö
ë~	ê
RH	rh

GH	gh
HHH	hh
FH	fh
BB	bb
RR	rr
TS  ts
DZ  dz
H+	h=
SH+	s=
R'	ṙ
D'	ḋ
:	:
-	-
//ψ π ж ю